########################################
#######################  ######      ###
##################  ##    #####       ##
###### #########          #####        #
#####  #########           ####        #
####   #########            ####       #
###     ########            ####       #
##         #####             ####      #
##    ##   #####              ###      #
##           ##                #       #
#                                      #
###### #########          #####        #
#####  #########           ####        #
####   #########            ####       #
###     ########            ####       #
##         #####             ####      #
##    ##   #####              ###      #
##           ##                #       #
########################################