########################################
#######################..######......###
##################..##....#####.......##
######.#########..........#####........#
#####..#########...........####........#
####...#########............####.......#
###.....########............####.......#
##.........#####.............####......#
##....##...#####..............###......#
##...........##................#.......#
#......................................#
#.........####........................##
##........#####.......................##
##.........#####......................##
##..........####.......................#
####...................................#
####...................................#
####...................................#
##########...........##############...##
########################################
    
    
