########################################
#######################..######......###
##################..##....#####.......##
######.#########..........#####........#
#####..#########...........####........#
####...#########............####.......#
###.....########............####.......#
##.........#####.............####......#
##....##...#####..............###......#
##...........##................#.......#
#.........@............................#
########################################